..█████████████████████████████████████████████████████████████.
█...█.█.█...█...█...█.█...........█...█.....█.█...█...........█.
█.███.█.█.█████.███.█.███.█.███.█.█.█.█.█.███.███.█.█.███.█████.
█...█.█...█.........█.█.█.█.█...█...█.█.█.█...█...█.█.█.█.█...█.
█.███.███.█.███████.█.█.█.█.███.█.███.███.███.█.█.███.█.█████.█.
█.█...█.....█.█.█.█...█...█...█.█...█.......█...█.█.....█.....█.
█.█.███████.█.█.█.███.█████.███.█████.█████████.███.█████.███.█.
█...............█.█...█...█...█.█.....█.....█...█.█...█...█.█.█.
█.███████.███████.█.█.███.███.███████████.█████.█.█.█████.█.███.
█...█.......█.....█.█...█...█...█.█...........█.....█.█...█...█.
███.█████████.█████.█████.███.███.█.███████.███.███.█.█.███.███.
█...█.........█.....█...█.............█...█.█...█.█.█.....█...█.
███.█.█.█████████.█████.███.█.█.█.███.███.███.█.█.█.█████.█.█.█.
█...█.█.█...█.....█.....█.█.█.█.█.█.█.....█...█.█...█.█...█.█.█.
███.█.███.███.███.█.█.█.█.█.███████.█.█.███████████.█.███.█.███.
█.........█.....█.█.█.█.█.█...█.....█.█...█.......█.█.█...█.█.█.
█.█.█.███████.█████.█████.███.█████.█.███████████.█.█.███.█.█.█.
█.█.█.....█.█.█.█...........█.█...█...............█...........█.
█.███████.█.███.███.███.█.███.█.███████████.█.█████.███████.█.█.
█.█.█...█...........█...█.........█.......█.█...█.█...█.█.█.█.█.
█.█.█.███.█.█████.███.█.█.███.█████████.█.███████.█████.█.███.█.
█.█.█.....█.█.....█...█.█.█...█.█.......█.█...................█.
█.█.█.█.███.███.███.███.█████.█.█.███████.███████████.█████.█.█.
█...█.█...█.█.....█.█.█.█.....█...█.█.....█...█.█.....█.█.█.█.█.
█.███████.███████.███.█.███████.█.█.█.███████.█.█.█.███.█.█.█.█.
█.......█.....█...█...█.█...█...█.█...█...█.......█.█.....█.█.█.
█.█.█.███████.█.█.███.███.█.█████.█.███.███.███.███████.███████.
█.█.█.....█.█.█.█.█.█.....█.█.....█.█.....█...█.█...█...█.....█.
███.█.█████.█.███.█.███████.█.█.█████████.█.█████.███.█.███.███.
█.█.█.......█.█.....█...█.█...█.............█...█.....█...█...█.
█.█████.███████.█████.███.███.█████████.███.█.███.███.███.█.███.
█.█.........█...█.█...........█.........█.█.█...█.█...█.......█.
█.█.███.███.███.█.███.█.█.█.███.█████████.█.█.█.█.█.█.███████.█.
█.....█.█.....█.......█.█.█.█...█...........█.█...█.█...█.....█.
█.███.███████████.███████.███.█.█████.█████.█.███.███████████.█.
█...█.█.█...█.█.█...█.█.█.█...█.█.█.....█.....█.█.█.█.....█...█.
███.███.█.███.█.█████.█.█████████.█████████.█.█.███.█████.█.█.█.
█...█.█...█.......█.....█.....█.........█.█.█...█...█.█.█...█.█.
█████.█.█.███.█.█.███.███.█.█.█.█.█.█████.█.█.█.███.█.█.███.███.
█.█.█...█.█...█.█...█...█.█.█...█.█.█.......█.█.█.█.█.....█...█.
█.█.█.███.███.█.█.███.█████.█████.█████████.█████.█.█████.█.█.█.
█.......█.█...█.█.█.........█...█.....█.........█...........█.█.
███.█.███.█.███████.█.█████.█.█████████████.█████.█████████.█.█.
█...█...█...█...█...█.█.█.....█.......█.█...█...█.......█...█.█.
███.███.█.███.███.███.█.█████.███████.█.███████.█.█████████.███.
█.....█.█...........█...█.█...█.....█.....█.█.........█.......█.
█.█.█████.█.███.███.███.█.█.███.█████.█.███.███.███.█████████.█.
█.█.█...█.█.█...█...█.█...█.█.....█...█.█.....█.█.....█.......█.
█.█████.███.███████.█.█.███.█████.█████.█████.█████.█████.█████.
█.....█...█.█...█.....█...█.....█...█.......█.....█.█.......█.█.
█.███████.█████.███.███████.█.█████.█.█.█████.███.███████.███.█.
█.......█...█...█.....█.....█.█...█...█.█.......█.█.█.....█.█.█.
█.█████████.███.█.███████.█████.███.█████.███.███.█.█.█████.█.█.
█.█.....█...█...█.█.......█.█...█.....█.█.█.....█...........█.█.
███.███.█.█.█.█.█.█.███████.█.█.█.█.█.█.█.█████.█████.███.███.█.
█...█...█.█...█...█...█...█...█...█.█...█.....█...█.....█.....█.
█.███████.███.█.███.█.█.█.███.█████.███.█.█.█.█.█████████████.█.
█...█.....█.█.█.█.█.█...█.....█.█.█.█.....█.█.█.........█.█...█.
█.█.███.███.███.█.███.█████.█.█.█.█.███.█.███.███.███.█.█.█.███.
█.█.......█.█...█...█...█...█.█.█.█.█...█...█...█.█...█...█.█.█.
███.█.█████.█.█████.█.███.█████.█.█.█.███████████.█████.███.█.█.
█...█.......█.█.......█.........█...█.█.............█.....█.....
██████████████████████████████████████████████████████████████..
